

11111
1P0C1
10C01
1E0E1
11111




