











111111
1P0011
111011
101C11
101E11
111111
11CC11
111111




























