

11111
1P0C1
10C01
100E1
11111




