

11111
1P0C11
10C011
100E11
111111




