

11111
1P0C1
1C101
1E1C1
10C01
11111